18 14
192 528
5 0 0 0 0 0 0 0 0 0 0 0 0 0 0 0 0 7
2 15 15 15 15 15 15 15 15 15 15 15 15 15 15 15 15 3
2 15 15 25 15 15 15 15 15 15 15 15 15 15 25 15 15 3
2 15 25 25 25 15 15 15 15 15 15 15 15 25 25 25 15 3
2 15 15 25 15 15 15 15 15 15 15 15 15 15 25 15 15 3
2 15 15 15 15 15 15 15 15 15 15 15 15 15 15 15 15 3
2 15 15 15 15 15 15 15 15 15 15 15 15 15 15 15 15 3
2 15 15 15 15 15 15 15 15 15 15 15 15 15 15 15 15 3
2 15 15 15 15 15 15 15 15 15 15 15 15 15 15 15 15 3
2 15 15 25 15 15 15 15 15 15 15 15 15 15 25 15 15 3
2 15 25 25 25 15 15 15 15 15 15 15 15 25 25 25 15 3
2 15 15 25 15 15 15 15 15 15 15 15 15 15 25 15 15 3
2 15 15 15 15 15 15 15 15 15 15 15 15 15 15 15 15 3
4 1 1 1 1 1 1 1 1 1 1 1 1 1 1 1 1 6









